NO ../tiles/north.xpm
SO ../tiles/south.xpm
F 1,1,1
WE ../tiles/west.xpm
EA ../tiles/east.xpm
C 98, 47, 34
 1111111111111111
 1111111111111111111111111111111111111111
100000111010000011111111111
 1010000010110E00001001
 1010000010110000001001
 1111111111101111111111
         111111


