

NO ./tiles/north.xpm
SO ./tiles/south.xpm
WE ./tiles/west.xpm
EA ./tiles/east.xpm
F 1,1,1
C 98, 47, 34

 1111111111111111111111
 101001000010000111 101
11000111010001011101001
 1010000010110E00001001
 1111111111011111110111
         1111
