NO ./tiles/north.xpm
SO ./tiles/south.xpm
WE ./tiles/west.xpm
EA ./tiles/east.xpm
F      128,128,128
C 98, 47, 34

	111111111111111   1111111111111111111
	100000000000001   1000000000000000001
	100000000000001   1000000000000000001
	100000000000001   1000000000000000001
	100000000000001   1000000000000000001
	100000000000001   1000000000000000001
	100000000000001   1000000000000000001
	100000000000001   1000000000000000001
	100000000000001   10000000000W0000001
	100000000000001   1000000000000000001
	100000000000001   1000000000000000001
	111111111111111   1111111111111111111
